ant	con kiến(danh từ), con mối(danh từ)
baby	trẻ thơ(Danh từ)
back	lưng(Danh từ)
bad	xấu(Tính từ)
ball	quả bóng(Danh từ)
band	băng(Danh từ)
bank	bờ(Danh từ)
bar	quán bán rượu(Danh từ)
base	cơ sở(Danh từ)
basic	cơ bản(Tính từ)
bear	mang(Động từ)
beat	đánh đập(Động từ)
beauty	vẻ đẹp(Danh từ)
bed	cái giường(Danh từ)
before	trước(Trạng từ)
begin	bắt đầu(Động từ)
behind	sau(Trạng từ)
believe	tin(Động từ)
bell	cái chuông(Danh từ)
between	giữa(Trạng từ)
big	to(Tính từ)
bird	chim(Danh từ)
bit	miếng(Danh từ)
black	đen(Danh từ)
block	khối(Danh từ)
blood	máu(Danh từ)
blow	sự nở hoa(Danh từ)
blue	màu xanh(Danh từ)
board	tấm ván(Danh từ)
boat	tàu(Danh từ)
body	thân thể(Danh từ)
bone	xương(Danh từ)
book	sách(Danh từ)
born	sinh(Động từ)
bottom	phần dưới cùng(Danh từ)
bought	mua(Động từ)
box	hộp, thùng(Danh từ)
boy	con trai(Danh từ)
branch	ngành(Danh từ)
bread	bánh mỳ(Danh từ)
break	sự vỡ(Danh từ)
bright	sáng(Trạng từ)
bring	mang(Động từ)
broad	rộng(Trạng từ)
brother	anh(Danh từ)
brown	nâu(Trạng từ)
build	xây dựng(Động từ)
burn	đốt(Động từ)
busy	bận(Trạng từ)
buy	mua(Động từ)
dad	bố(Danh từ)
dance	sự nhảy múa(Danh từ)
danger	sự nguy hiểm(Danh từ)
dark	tối(Danh từ)
day	ngày(Danh từ)
dead	chết(Trạng từ)
deal	sự giao dịch(Danh từ)
dear	thân(Danh từ)
death	sự chết(Danh từ)
decide	quyết định(Động từ)
divide	chia(Động từ)
do	làm(Động từ)
doctor	bác sĩ y khoa(Danh từ)
dog	chó(Danh từ)
dollar	đô la Mỹ(Danh từ)
drink	đồ uống(Danh từ)
drive	cuộc đua xe(Danh từ)
drop	giọt(Danh từ)
dry	khô(Trạng từ)
duck	con vịt(Danh từ)
ear	tai(Danh từ)
early	sớm(Trạng từ)
earth	trái đất(Danh từ)
ease	sự thanh thản(Danh từ)
east	hướng đông(Danh từ)
eat	ăn(Động từ)
edge	lưỡi(Danh từ)
effect	hiệu ứng(Danh từ)
egg	trứng(Danh từ)
end	sự kết thúc(Danh từ)
enemy	kẻ thù(Danh từ)
energy	năng lượng(Danh từ)
engine	máy(Danh từ)
enter	 đi vào(Động từ)
exact	chính xác(Trạng từ)
example	thí dụ(Danh từ)
excite	kích động(Động từ)
expect	chờ đợi(Động từ)
face	mặt(Danh từ)
fact	sự kiện(Danh từ)
fair	hợp lý(Trạng từ)
fall	sự rơi(Danh từ)
family	gia đình(Danh từ)
famous	nổi tiếng(Trạng từ)
far	xa(Trạng từ)
farm	trang trại(Danh từ)
fast	nhanh(Trạng từ)
fat	chất béo(Danh từ)
father	cha(Danh từ)
favor	sự quý mến(Danh từ)
fear	sự sợ hãi(Danh từ)
feed	cho ăn(Động từ)
feel	cảm thấy(Động từ)
few	ít(Trạng từ)
field	cánh đồng(Danh từ)
fight	sự đấu tranh(Danh từ)
free	miễn phí(Tính từ)
fresh	tươi tắn(Trạng từ)
friend	người bạn(Danh từ)
fruit	trái cây(Danh từ)
full	đầy(Trạng từ)
fun	hài hước(Trạng từ)
game	trò chơi(Danh từ)
garden	vườn(Danh từ)
gas	khí(Danh từ)
gather	hái(Động từ)
general	chung(Tính từ)
gentle	hiền lành(Tính từ)
get	có được(Động từ)
girl	con gái(Danh từ)
give	cho(Động từ)
glad	vui lòng(Tính từ)
go	đi(Động từ)
gold	vàng(Danh từ)
guess	oán(Động từ)
guide	chỉ đường(Động từ)
gun	súng(Danh từ)
hair	tóc(Danh từ)
half	một nửa(Danh từ)
hand	tay(Danh từ)
happen	xảy ra, xảy đến;
happy	vui sướng(Tính từ)
hard	cứng(Tính từ)
hat	cái mũ(Danh từ)
have	có(Động từ)
head	cái đầu(Danh từ)
hear	nghe(Động từ)
heart	tim(Danh từ)
heat	sức nóng(Danh từ)
heavy	nặng(Tính từ)
help	sự giúp đỡ(Danh từ)
high	cao(Tính từ)
history	lịch sử(Danh từ)
hit	cú đấm(Danh từ)
hold	sự nắm giữ(Danh từ)
home	nhà(Danh từ)
hope	hy vọng(Danh từ)
horse	ngựa(Danh từ)
hot	nóng(Tính từ)
hour	giờ(Danh từ)
house	nhà(Danh từ)
how	thế nào(Trạng từ)
huge	to lớn(Tính từ)
ice	băng(Danh từ)
idea	tưởng(Danh từ)
imagine	tưởng tượng(Động từ)
in	ở(Trạng từ)
inch	insơ(Danh từ)
include	bao gồm(Động từ)
insect	sâu bọ(Danh từ)
interest	sự thích thú(Danh từ)
invent	phát minh(Động từ)
iron	sắt(Danh từ)
island	hòn đảo(Danh từ)
job	việc(Danh từ)
join	gia nhập(Động từ)
joy	niềm vui(Danh từ)
jump	bước nhảy(Danh từ)
just	đúng(Trạng từ)
keep	giữ(Động từ)
key	chìa khóa(Danh từ)
kill	giết(Động từ)
kind	loại(Danh từ)
king	vua(Danh từ)
know	biết(Động từ)
lady	người yêu(Danh từ)
lake	hồ(Danh từ)
land	đất(Danh từ)
language	ngôn ngữ(Danh từ)
large	rộng(Trạng từ)
late	trễ(Trạng từ)
laugh	tiếng cười(Danh từ)
law	luật(Danh từ)
lay	xếp, đặt, bố trí;
lead	sự lãnh đạo(Danh từ)
learn	học(Động từ)
leave	bỏ đi(Động từ)
left	bên trái(Danh từ)
length	chiều dài(Danh từ)
let	cho phép(Động từ)
letter	thư(Danh từ)
level	trình độ(Danh từ)
lie	lời nói dối(Danh từ)
lift	sự nâng(Danh từ)
light	ánh sáng(Danh từ)
line	dây(Danh từ)
liquid	chất lỏng(Danh từ)
list	danh sách(Danh từ)
long	dài(Trạng từ)
look	nhìn(Động từ)
lost	thua(Trạng từ)
loud	to(Trạng từ)
low	thấp(Trạng từ)
machine	máy, máy móc(Danh từ)
main	chính(Trạng từ)
major	lớn(Trạng từ)
make	sự chế tạo(Danh từ)
man	on người(Danh từ)
map	bản đồ(Danh từ)
market	chợ(Danh từ)
mass	khối(Danh từ)
master	chủ nhân(Danh từ)
match	trận thi đấu(Danh từ)
material	nguyên vật liệu(Danh từ)
matter	chất(Danh từ)
may	tháng 5(Danh từ)
mean	nghĩa(Động từ)
measure	sự đo lường(Danh từ)
meat	thịt(Danh từ)
meet	gặp(Động từ)
metal	kim loại(Danh từ)
method	phương pháp(Danh từ)
middle	giữa(Danh từ)
mile,	dặm(Danh từ)
milk	sữa(Danh từ)
mind	tâm trí(Danh từ)
mine	của tôi(Danh từ)
minute	phút(Danh từ)
miss	cô gái(Danh từ)
mix	sự pha trộn(Danh từ)
modern	hiện đại(Trạng từ)
moment	chốc(Danh từ)
money	tiền(Danh từ)
month	tháng(Danh từ)
moon	mặt trăng(Danh từ)
morning	buổi sáng(Danh từ)
mother	mẹ(Danh từ)
motion	sự chuyển động(Danh từ)
mountain	núi(Danh từ)
never	không bao giờ(Trạng từ)
new	mới(Tính từ)
next	sát(Trạng từ)
night	đêm(Danh từ)
noise	tiếng ồn(Danh từ)
nor	cũng không(Trạng từ)
nose	mũi(Trạng từ)
note	lời ghi(Danh từ)
notice	thông báo(Danh từ)
now	bây giờ(Trạng từ)
number	số(Danh từ)
object	vật(Danh từ)
observe	quan sát(Động từ)
off	tắt(Động từ)
offer	biếu(Động từ)
office	cơ quan(Danh từ)
often	thường, hay, luôn;
oil	dầu(Danh từ)
old	già(Tính từ)
once	một lần(Trạng từ)
only	duy nhất(Tính từ)
open	mở(Động từ)
page	trang(Danh từ)
paint	sơn(Danh từ)
pair	đôi(Danh từ)
paper	giấy(Danh từ)
parent	cha, mẹ(Danh từ)
part	phần(Danh từ)
particular	riêng biệt(Tính từ)
party	tiệc(Danh từ)
pass	 qua(Động từ)
past	quá khứ(Danh từ)
path	đường mòn(Danh từ)
pattern	mẫu(Danh từ)
pay	tiền lương(Danh từ)
people	dân tộc(Danh từ)
perhaps	có thể(Trạng từ)
period	kỳ(Danh từ)
person	con người(Danh từ);
phrase	câu(Danh từ)
picture	bức vẽ(Danh từ)
piece	mảnh(Danh từ)
pitch	sân(Danh từ)
place	nơi(Danh từ)
plan	bản đồ(Danh từ)
plane	mặt phẳng(Danh từ)
planet	hành tinh(Danh từ)
popular có tính đại chúng(Tính từ)
pretty	xinh xắn(Tính từ)
produce	chế tạo(Động từ)
product	sản phẩm(Danh từ)
proper	đúng(Trạng từ)
question	câu hỏi(Danh từ)
quick	nhanh(Tính từ)
quiet	yên lặng(Tính từ)
quite	hoàn toàn(Trạng từ)
race	loài(Danh từ)
radio	sóng vô tuyến(Danh từ)
rail	đường ray(Danh từ)
rain	mưa(Danh từ)
raise	nâng lên(Động từ)
range	dãy(Danh từ)
rather	thà còn hơn(Trạng từ)
reach	đến(Động từ)
read	đọc(Động từ)
ready,	sẵn sàng(Tính từ)
real	thực tế(Tính từ)
reason	lý do(Danh từ)
receive	nhận(Động từ)
record	bản ghi(Danh từ)
red	màu đỏ(Danh từ)
region	vùng(Danh từ)
remember	nhớ(Động từ)
repeat	nhắc lại(Động từ)
reply	trả lời(Động từ)
result	kết quả(Danh từ)
rich	giàu(Tính từ)
ride	sự đi(Danh từ)
right	thẳng(Tính từ)
ring	chiếc nhẫn(Danh từ)
rise	sự lên(Danh từ)
river	sông(Danh từ)
road	con đường(Danh từ)
room	phòng(Danh từ)
safe	an toàn(Tính từ)
sail	đi tàu(Động từ)
salt	 muối(Danh từ)
same	đều đều(Tính từ)
sand	cát(Danh từ)
sat	ngồi(Động từ)
save	cứu(Động từ)
say	nói(Động từ)
scale	vảy(Danh từ)
school	trường học(Danh từ)
science	khoa học(Danh từ)
score	điểm số(Danh từ)
sea	biển(Danh từ)
search	sự tìm kiếm(Danh từ)
season	mùa(Danh từ)
seat	ghế(Danh từ)
self	bản thân mình(Danh từ)
sell	bán(Động từ)
send	gửi(Động từ)
sense	giác quan(Danh từ)
sentence	câu(Danh từ)
serve	phục vụ(Động từ)
set	bố trí(Động từ)
settle	giải quyết(Động từ)
shine	chiếu sáng(Động từ)
ship	tàu(Danh từ)
shoe	giày(Danh từ)
shop	cửa hàng(Danh từ)
shout	hò hét(Động từ)
show	biểu diễn(Động từ)
side	mặt phẳng(Danh từ)
sight	cảnh đẹp(Danh từ)
sign	đánh dấu(Động từ)
silent	im lặng(Tính từ)
sing	hát(Động từ)
single	đơn độc(Tính từ)
sister	chị, em gái(Danh từ)
sit	ngồi(Động từ)
song	bài hát;
soon	sớm(Trạng từ)
sound	âm thanh(Danh từ)
space	khoảng trống(Danh từ)
speak	nói(Động từ)
special	đặc biệt(Tính từ)
speech	lời nói(Danh từ)
speed	tốc độ(Danh từ)
spell	đánh vần(Động từ)
spend	tiêu(Động từ)
suit	bộ com lê(Danh từ)
summer	mùa hè(Danh từ)
sun	mặt trời(Danh từ)
supply	sự cung cấp(Danh từ)
support	sự chống đỡ(Danh từ)
sad	buồn(tính từ)
table	cái bàn(Danh từ)
tail	đuôi(Danh từ)
take	sự cầm nắm(Danh từ)
talk	nói chuyện(Động từ)
tall	cao(Tính từ)
teach	dạy(Động từ)
team	đội(Danh từ)
tell	nói(Động từ)
temperature	nhiệt độ(Danh từ)
term	giới hạn(Danh từ)
test	bài kiểm tra(Danh từ)
thank	cám ơn(Động từ)
thick	dày(Tính từ)
thin	mỏng(Tính từ)
thing	cái, đồ, vật(Danh từ)
think	nghĩ, suy nghĩ(Động từ)
trouble	điều lo lắng(Danh từ)
truck	rau quả tươi(Danh từ)
true	đúng(Tính từ)
try	thử, cố gắng(Động từ)
unit	đơn vị(Danh từ)
up	ở trên(Trạng từ)
use	sử dụng(Động từ)
usual	thông thường(Tính từ)
valley	thung lũng(Danh từ)
value	giá trị(Danh từ)
vary	thay đổi(Động từ)
very	rất(Trạng từ)
view	sự nhìn(Danh từ)
village	làng(Danh từ)
visit	đi thăm(Động từ)
voice	giọng nói(Danh từ)
wait	chờ đợi(Động từ)
walk	đi(Động từ)
wall	tường(Danh từ)
want	muốn(Động từ)
war	chiến tranh(Danh từ)
warm	ấm(Tính từ)
wear	mặc(Động từ)
weather	thời tiết(Danh từ)
week	tuần(Danh từ)
weight	trọng lượng(Danh từ)
well	giỏi(Tính từ)
wood	gỗ(Danh từ)
word	từ(Danh từ)
work	làm việc(Động từ)
world	thế giới(Danh từ)
write	viết(Động từ)
year	năm(Danh từ)
yellow	vàng(Danh từ)
young	trẻ(Danh từ)